TT TTTTTTTTTTTTTTTTTTTTTTTTTTTTTT
TTTTTTTTTTTTTTTTTTTTTTTTTTT     T
TTT TTTTT  TTTTT  TTTTTTTT    D T
TT TTTTTT  TTTTT TTTTTTTT       T
TT TTT TTT TTTTT       T        T
TTTTTTTTTT TTTT     T  TT    T TT
T TT TTTTTTTTTTT     T TT    T TT
TTTTTTTTTTTTTTTTTTTTTT      T T T
TTTTTTTTT TTTTTT TTT          TTT
TTT TTTT TTTTTTT TT T       TT  T
TTTT TT TTTTTTTTTT T       TTTTTT
TTTTTTTTTT   TTT TT       TTTTTTT
TTT TTTTTTTT TTT         TTT TTTT
TTTTT TTTTTT TTT        TTTT TTTT
TTTT TTTTT TTTT T       TTTT TTTT
TTTTTTTTTTTTT           TTTTTTTTT
TTTTT  TTT T         TTTTTTTTTTTT
TTTTTT TT TT        T TTTTTTTTTTT
TTTTTTT  TT        TTTTTTTT   T  
TT TTTTT  T        TTTTTTTTT   TT
TT TTTTTTT          TTTTTTTT  TTT
TTT TTT           TTT TTTTTTTTTTT
TTT  TTT T     TTTTTT TTTT  TTTTT
TTT TTTT      TTTTTT TTTT TTTTTTT
TTTTTTT      TT TTT TTTTTTTTTTTTT
TTTTT       TTTT TTTTTTTTTTTTTTTT
 TTTTT     TTTTTTT    T TTTT TTTT
T  TT      TTTTTTTTTTT TTTTTTTTTT
 TTT     TTTTTT T TTTTTTTTTT TTTT
T        TTTTTTTTTTT  TTTTTTTTTTT
T R     TTTTTT TTTTTTTTTTTT TTTTT
T       TTTTTTT TTTTTTTTTTTTTTTTT
TTTTTTTTTTTTTTTTTTTTTTTTTTTTTTTTT
