TT TTTTTTTTTTTTTTTTTTTTTTTTTTTTTTTTTTTTTTTT  TTTTTTTTTTTTTTTTTTTTTTTTTTTTTTTTTTTTTTTTTT
TTTTTTTTTTTTTTTTTTTTTTTTTTTTTTTTTTTTTTTTTT  TTTTTTTTTTTTTTTTTTTTTTTTTTTTTTTTTTTTTT    T
TTT TTTTT  TTTTT  TTTTTTTTTTTTTTTTTTTTTT  TTTTTTTTTTTTTTTTTTTTTTTTTTTTTTTTTTTTTTTT  D T
TT TTTTTT  TTTTT TTTTTTTTTTTT T TTTTTTTTTTTTTTT TTTTTTTTTTTTT                         T
TT TTT TTT TTTTT       TTTTTT T   TT  TTTTTT  T TTTTTTTTTTTT                         TT
TTTTTTTTTT TTTT     T  TTTTTTTTTTTTTTTTTTT TTTT TTTTTTTTTTT                         TTT
T TT TTTTTTTTTTT     TTTTTTTTTTTTTTTTTTTTTTTTTTTTTTTTTTTT                         TTTTT
TTTTTTTTTTTTTTTTTTTTTTTTTT  TTT TTTTTTTTTTTTTTTTTTTT                         TTTTTTTTTT
TTTTTTTTT TTTTTT TTTTTTTTTT   TTTTTTTTTTTTT  TTTTTTT                         TTTTTTTTTT
TTT TTTT TTTTTTT TTTTTTTTTTTTT  TT TTTTTTTTTTTTTT                        TTTTTTT TTTTTT
TTTT TT TTTTTTTTTTTTTTT T TTTTTTT TTTTTTTTTTTTTTT            d            TTT    TTTTTT
TTTTTTTTTT   TTTTTTTTTTTTTTTTTTT TTTTT   TTTTTTT                         TTTTTTTTTTTTTT
TTT TTTTTTTT TTTT  TTTTTTTTT TTTTTTTTTTTTTTTTT                         TTTTTTTTTTTTTTTT
TTTTT TTTTTT TTTTTTTTTTTTTTT TTTTTTTTTTTTTTT   T                     TTTTTTTTT TTTTTTTT
TTTT TTTTT TTTTTTTTTTTTTTTTT TTTTTTTTT                         TTTTTTTTTTTTTTTTTTTTTTTT
TTTTTTTTTTTTT TTTTTT TTTTTTTTTTTT                         TTTTTTT  TTTTTTTTTTTTTTTTTTTT
TTTTTTTT TTTT TTTTTTTTTTTTTTT                         TTTTT  TTT T TTTTTTTTTTTTTTTTTTTT
TTT TTT TTTTTTTTTTTTTTTTTT                         TTTTTTTTT TT TT TTTT  TTTTTTTTTTTTTT
TTTTTT TTTTTTTTTTTTTTTTT                         TTTTTTTTTTTT  TT TTTTTTTTTTTTTTT   T  
TTTTTTTTTTTTTTTTT T                         TTTTTTTTTTTT TTTTT  TTTTTTT TTTTTTTTTT   TT
TTTTTTTT   TTTTTTT                         TTTTTTTTTTTTT TTTTTTTTTTTT  TTTTTTTTTTT  TTT
 T TTTTT TTTTTTTT                         TTTTTT   TTTTTT TTTTTTTTTTTT TTTTTTTTTTTTTTTT
     TTTTTTTTTT            r            TTTTT T TT TTTTTT  TTTTTTTTTTTTTTTTTTTTT  TTTTT
  TTT TTTTTT                      TT TTTTTTTTT TTTTTTTTTT TTTTTTTTTTTTTTTTTTTTT TTTTTTT
  TTT TTTTTT                         TTTTTTTTTTTTTTTTTTTTTTTTTTT  TTT TTTTTTTTTTTTTTTTT
TTTTTTTTTT                         T TTTTT TTT TTTT   TTTTTTTTT TTTTTT TTTTTTTTTTTTTTTT
TTTTTTTT                         TTTTTTTTTTTTTTTTT TT  TTTTTTTTTTTTTTTTT    T TTTT TTTT
T TTTT                         TTTTT TTTTTTTTTTTTTTTTTT  TTTTTTT TTTTTTTTTTT TTTTTTTTTT
TTTT                         TTTTT TTTTTT  TTTTTTTTTT  TTTTTTTTTTTTTT T TTTTTTTTTT TTTT
T                         TTTTTTTTT TTTTTTT TTTTTTT   TTTT TTT TTTTTTTTTTT  TTTTTTTTTTT
T R   TTTTTTTTTTTTTTTTTTTTTT   TTTTTTT TTTT TTTTTTTTTTTTTTT  TTTTTTT TTTTTTTTTTTT TTTTT
T     TTTTTTT   TTTTTTTTTTTT TTTTTTTTTTTTTTTTTTTTTTT   TTTTTTTTTTTTTT TTTTTTTTTTTTTTTTT
TTTTTTTTTTTTTT TTTTTTT    TTTTTTTTTTTTTT    TTTTTTT TT  TTTTTTTTTTTTTTTTTTTTTTTTTTTTTTT
